>chr3:183815876-183825594
AAGCGTGAGAAGACTCGTGCTTATAATTTAAGAAACTGAAACTACATTTTTGCATTTTAG
TAAAATCTGAGATTGTACAGTTTTTAATCTCATTTCCACAGACACCCAGCAGGCAGCCTC
TTTTCTCTTAGAAAAATCAAACATGCAAGCCGTGAAGTCAGGAATAGCTGAACCCCTTGG
ATAAGCACACGCTTTGGGCTTCTTTAAAGCGAGCCTCTCATCAAGAGCATTTCCTTTGCT
GGCATGAGGGGAGGGCTGTGCCTGCCAGGGCTAGCACCTGGGAGGGACGCTGACAGGCAG
TCGGAGCTGGAACCACTGTCCCACCTGCACGTCTGGTGGCTCTGAGACCCGAGTGCCACC
ACCTGCAGCTTAAATGCTCGTCTCACTAGAGCCACTTGTGGGCTGGAGAGGAAGAAAGAT
CCAAAGGGAAATCCACAAATTTCCTTACTGAAGACTGTCCTGAGCTTGTACCTCTAAGCT
TTAAAAAGAGACGAAGACCCCTCAAACGTGTGAAGGCACCAGGCGTGACCCATGTGGCCA
TGCTGGCTGGAATTTACGGAGGAAGTTAGGAGAGAGCTTTGCAAAGAAAATGAACTGCCT
CTTCAAAAGGTGGTGAGTTCCCCGTCACTGTACATGTGAGCAGGGTAGACGGAAGGGTTG
GTGTAGAGGACATTTTAAGGTATTTCAGGGAATGAGACAAATGCCACCTTCCCAAAAACA
GTTCCAGTTCTCAGCCAGTGTGTATGATAGTGCCCTGCTCATCATCCTTATGTTAGCGGG
AAAATCATTAGTAACAAAATGTGGATTCAATCTTTAGAACCTAGCACAAGGTAAATGTGA
GTCATTCAATCCCAAGAACTGTTTTGTTAAAACATGAGGCTCATCTTGGCCATAAGGAGG
TCTGTGAAGTGGAAGCCCGTGACTGACGGTCTGTTTCTTCTGGAAATTTCCTCCTGGATA
CTCAGCATCACCATGAGTCATGCAGGTGACGGCCCAAGATTCCAACAGCTTCAACTGCAG
GGGCCATTTGTAGGAAGAGCCAAGGGTCTCACTGTAGGTTATGAAATTAATCAAGTGCTC
ACGCATCCTGGGAAATCCACCAAAAGTGGACATAACTGGTTCTTTCAAGGGCCGGATGTG
TCCACATTCCTCAGCTTCCATGGACCAATTCGGTTCCCAACTGACTTGATCCTCAGGCTC
CTCAGAGATTTCAAAACTGAGAGACGGCCAGATGGCAGTTAACGAACGCAGGAGCCTTCC
ACAGGCTTCTCAAGAGGATGCTTGAGGCTGAGCTGGGTGTGCCAAGTCCATCGGTGCATC
TGCTCCACACCAGCACTTTGGCCCTGGTGACAGCTTTGAGAGGGGCTGTGCCCTCCCGCA
GGGGCCCATGCCATGCTCTCGCCCAGCCCCGCGGCAGTGGGTCCTGAGGCCGCTCCCCAG
CCCTGTCCTGTCGGCAGCCATGGTGTCACGGTGCAGGCAGTCACACGTTGAGAATCCGGG
GAGCTGAGGCCTGAAAGATGGCGGAGGGGTTAGGAGTGAACTTCTTCCTCACCTCTGGGA
CCTGAAAAATGAAGTGTGGCCACATATCAGTGGGACTTTTCCTTAACTCCCTACTCTTCC
CCACTACCCAGCTCCAGGAAAAAATCCCCTCCCATCCTCTGCATCCTCCAGGAGTTGAGA
CCTGAAGGGTCAGAGGGGACTTGCCCACCGTGAGCCATAGGCGTCACTGCATTAGCAGCT
GAGTGGTACACGGACCTTCCATTCTGCTCCCTGAACCACTTGGGAATCGGAGCTGAGATG
CCCCCACTCCCTTCCATCGTCTCTTTCCTCTTACACAAATGCTGTGGTACTCAGGCCAGT
CACTAGCGTTCAGTGGCCAAGGGTAAGATGGGGATTTAGGAGGCAGAGAGACCCTGCTCA
CCAGAGAGGCCAACGCTAGAGGGCCACCCAGCTGGCTACTGATGAGGAAGTACCTTGGGT
TTTTGTTCGGGACATCTGGTTGGCACTGCTGTCCCTGGTCATAATTGCATTTTACACCAT
GAAAATCTGGCTCCTAATCCCTACCCGGGGAAAGAGGCCTCTATACCCACACCCCTGCTA
CACCAGCTTCCGGCTGACCTGGAAGCCGGCCCCAGGGCTGCTGTCCCATCCCGAAGTGTG
GGTTGTGATGACTCGGGCTGGTTTTGTCTTTGTGGATCTTGAGGGCTTCACTCCAGTCCA
AGCCTGGAATTCCTGTCTGGAACAGAGAACACGGTCACAAGCTTGCACAGGGTCAGCCAC
CCCTTTACCGACTCCCCAGGGGCTGCTGCTCTGCCCCATGCACGGCCCTGCCAATTGCTG
AAACCCTCGGCTCCAGGCAGTCCTCATCATCTTCCCAAAGACAGAACTGGCAAGGCAAGT
GCACTCCCGTGCAGGCCCAGCTCCAGGAGAAAGGTGTGTGGCTGCCTGGCCCCTCACCTC
AGCGATCCACTGGGAAATCTGGGCTCACCCCGGTCCCTAAGGAAGTAGGAGAGGAAGCTT
ATTCTCACACTGCAGGCGAGCGGCAGGGTCAGGGCAGAGCTCAGTTAGCACCTGGGTCTC
ATTCAGAACGCAACAGCACCTGGCACTGCTGGGTCTTGGAGACGAGCAGCCCCGGTGCTA
TACCTGCACCCCCTGCGATTCTCCCACACCTGCCCCTCCAGAGCCAGGCTGCTTCAAGAG
ACCCAGGTCATGGTGACTGCTTATGCCTGAAGAGGAAATGCCCTCAGCACCGGGCACAGC
CCTGGCTTGCCAGACCCGCTTAAGACTGAAAAGAAAAATAAGGCTCAGAACTTTTAGTTT
TTTATACTTTGTCTCATTAACTCATGCAGAAGAATGGATCGCAGTGACCATCTCAAAAGA
CTCCAAGGTGGCCTGGCCTTTGCACAGCTCTGTGCATGGTGGAGGGAGTGGATCATGCGC
TGTTGCTGAGCCTGTGGCGGGGAGGGTGGTGTGATGGGGGAAGGCGGGCCCTGGAGGGAG
AGGATGAGGCTGGCACCGCTAGCTCCATGTACCGGGAGCAGCTTTCTCCATGAAAAGACA
GTGCTTCCATTTCTCTGAACAAAAGGGACCTCCTTTAATTCTACCCACTCCTCTGCAAGA
TGGGGAGCTCAGAAGGCAGAAGTCCCTGTGTCCCAGGAGCACCTGGCCAAGGTGGAAGTG
TCCAGCTAGCTGGGCCTGGCACCCACGTGTGCGGAGTTGCTCCTGCCCAGGCTGGACACT
GCCGGGGTTGGGCTTCAGGCCCTGAGGTCAACAAAGCTGCCTTTCTCCTTGGCAGCTGCA
AAGCTGGGGCACCACTGGGCAGGCTGCGTGGGCAGGGAATGGCTGTGTCCATGGCCAGCA
CTGGGGTGCCAGGAGGAGAGCTAGGCCGGGGCCCCGTCAGGTAATTTTCACTCCCGAAGC
CGCGAGCTTCTGAAGACCAGCTGCCCAAACCATATGCTGCTCTGTTCCTCCTGCGGAAGC
AGGTCCTCCCCTGGGCGCGCCCTTCTGTCCCCAAAACACTTCACATGCCCACGCTGAGCC
TTGGGCCTGGCATCCTGAGCCCGCTGCCCTGAGGTGGCTGCAGGGGTCTCAGAGCAGGAA
GCCACCAGAGCCACAGACGACAGCAATCCTGGCGGCCGCCAGAGGAGGAACCCGGGGCTG
GAGCCCAGATGGGAGAGGGGACCTTAAAGATGGAATGGGCAGGACCCGGTGACTGCCTGG
AGAGAAAGAAAACAGACTCATGGCTCAGGCCAAGATTAGTAAGAAATACAGGCCTCCCTG
CCTGCTGTGCCCCCATACAGTGCTCAAGCATGTTCCGGCATCAGCCCCGGACAGAGGATT
GGGAGGCCTGGGTTCTCAGCCCAACATGGCTTCAGACACATTCCTCAACTTCCCTGAGCC
TCAGTTTCTTCTGAAAAGTGGGGCTGCTGACCCATGTGCCTGAGGCTGTTGTGAGTCTTC
GTTTCGGGCACTCAGTAAAGTGGGGCCAAGTCTTGTGGAACTTGAATATCAGCCCTTTAA
CTGCCCCACCTAGGCAGGAAGGAGGGAAGCAACCAGGGAGCAAGGACTGCCTTCCAGAAG
TGGGCGGGGCTAGCAACTGGGCCAAAGATGCCCAATGGCCCAGAGAGAATTCAGAGGGGG
CCTGTCAGGTGGAAGGAGCCAGGCTGGATGTGGGTAGGACCTGCTGTGCCCATGTGGCCA
GGCAGGCAAGGCAGATCAACTCACGTGCAGACCAGAAGCCAGCAAGGCAGGTCCTGCAGG
GGTGAAGAAGCTGAGGCCCGGGGATCCTGGGTACTCCCTCAAGAACCTTGAGTTAGGAGT
GGCCTCACATCTTCAGGATTCCTGGCTCTGTTCGTTTCCTTGGCTTTCTGAATTTCTTAA
GTTTGCTTAGATGATGTACATCTTACAAGACAAGGCTGGAGGGAGTGGCTTGTATCAGGT
CCCAGAGCTGGAAGGTGGGGGTCCCAGAGGCCCACTGGCATGGCGCTGGGAGGGTCAAGT
TCAACAGTGATCCTGTGTTTCTGCCCGAATTGGGGGCAGGGGTCCAGGCAGCCAAGCTCT
TGCTATTCCTGCTTTTCGGATGAAGAAAGGGTCAGAGAGGCTGACCCAGCCAGGCGCGGT
GGCTTAACGCCTGTAATCTCAGCACTTTGGGAGGGCAAGGCGGGCAGATCATGAGGTCAA
GAGAACGAGACCATCCTGGCCAACATGGTGAAACCCCGTCTCTACTAAAAATACAAAAAT
TAGGCCAGGCACAGTGGCTCATGCCTGTAATCCCAGCACTTCAGGAGGCTGGGGCGGGCG
GATCACGAGATCAGGAGATCGAGACCATCCTGGCTAACACGGTGAAACCCCGTCTCTAGT
AAAAAAAAAAAATACATAAAAATTAGCCAGGCATGGTGGCGGGCGCCTGTAGTCCCAGCT
ACTCGGGAGGCTGAGGCAGGAGAATGGCGTGAACCCGGGAGGCGGAGGTTGCAGTGAGCC
AAGGTTGCGCCACTGCACTCCAGCTTGGGCAACAAAGCAAGACTCCATCTCAAATAAATA
AATAAATAATACAAAATAAAAATACAAAAATTAGCTGGGTGTGGTGGTGGGCGCCTGTAG
TCCCAGCTACTCTGGAGGCTGAGGCAGGAGAATCGCTTGAACCCGGGAGGCGGAGGTTGC
AGTGAGCCGAGATGGCGCCACTGCACTCCAGCCTGGTGACAGAGTGAGACTCCGTCTCAA
AAAAAAAAAAAAGAAAAAAAGAGAGGCTGACCCACCTGAATTTACACACCAGGAGGTAAG
AACCCCAACAAGCCCCGACTCCTGTCTGTCAAGGCTTTTCCACAGCTGGCCTCAGGACAC
AGTTCAAGAAAGCAAGTGACTCCAAGGAGGCAGCTCTTAAGGGATGAAAACCCATGGGGG
CTACAAATTTGATCTCTGGGGCAAGTCACACGGGTTCCACTCCCTTCTCTGCCATTCAGA
GCTGTGCCAGCCACTCAGTTTCCTTGTCTGTAGAATGGGGACGGCAAGCACTACACGAAG
GCTGCAGGGGGCTAACCTCAGGGAGTGCTGAGCCTGGTGTGCGTTAAAGCAGAGAAGGCG
ACAGCTAGTACCTTCACCGTCACCAGAGCTGGGAGGGCCCGGCAGGACATTCACTCACCA
CATGTTCCACACAGATGAGGGATTGCTTTTTTTTTTTTTTTTTTTTTTGAGATGGAGTCT
CGCTCTATTGCCCAGGCAGGAGTGCAGTGGCTCTATCTCGGCTCACTGCGTCCTCCACCT
CCTGGGTTCAATGGATTCTCCTGCTTCAGCCTCCCGAGTAGCTGGGATTACAGGTGCGTG
CCATCACGCCCAGCTAATTTTTAGTAGAGATGGGGTTTCACTATGTTGGCCAGGCTGGTC
TCGAACTTGGGATCTGCCCATCTCATCCTCCCAAAGTGCTGGGGTTATAGGGGTGAGCCA
CCACGCCCGGCCTAATTTTTATATTTTTAGTAGAGACGGGGTTTCACCATGTTGGCCAGG
ATGGTCTTGAACTGACCTCAGGAGATCCGTCCATCTCGGCCTCCCAAAATGCTGGGATTA
CAGGTGTGAGCCACTGCGACCGGCCTCTTTTTAACTTTAAAATAAAAAAAAAGTAACTTC
TGTGATAAGCATCCTTACAGCTAAATCTTTGTTCATATCATCATTTCTTTGGGATAAATT
CCTAACTGTGGAATTAAAGAGCCAAAAAGTATGAACTTATCCCCCCAATTTTATTAGTTT
TAAAAACCAAGCTGGGCACAGTGGCTGATGCCTTTAATTCCAGCACTTTGGGAGGCTGAG
GCAGGAGGATCGCTTGAGCCCAGGAATTTGAGACCAGCCTGGGCAACATAAACCCCATCT
CTAAAACACACACACACACACACACACACACACACACACACACACACACACACACACAAA
ACCCCACATGTAGTGCCCACCTGTGGTCTCAGCTACTCGGGAGGCTGAGGTGAGAAAATC
ACTTGAGCCTGGGAGGTTGAGGCTGCAGTGAACTGAGATCATGTCCCTGCACTCCAGCCT
GGGCAACAGCAGCAACAACAACAAAACAAACAACAACAAAAAAACCCCCCAAAAACCCAA
CTGTATCAAGGCATTATTTCCAAACCATACAATTCATCCATTAAAAACATACAGCTGGAT
GACTTTTGACAAATGTAACCACTTGGGTACCACCACCATTATCAAGACACAAAGAACATT
CCATGTCCCCAGGAGGAGGCTCCCTCATAGGTCGGCACTTTGTAAGGAACTCGCTGGGGG
ACAGTGGTTGCAGGGTGGGTCTTGCATTCACTGACACGTCCTCAAGCTGAGCCGCCAAAG
CTGGAGTGGGCAACACTGAGCCGCAGCGCTCAGGCCCTAGACTAGCCAGCTGGAGGGGCC
TGAATAGCGGAGAGTCTGGAAGGCCAGGGGTCCTGAGCGTGCAGCGCATTCCAGCGGCTG
AAGTTCTAGGCACCAGAGCAGGGCAAGGGGTGGAGCTTGCAGGGAGACAGCTTCAGCTCC
GGGAAGGAAGCGCTTTCTGTCAGTTACAACAGTCTGCCCATGGAGCGAGCTGACTTGCAT
GGCGCTGGGCTCCTCTTTACTAGGGATGTTCTAGCAGAGGCTTAGCTTTTATTTATTTGA
AGCAAGGTCTTGCTCTGTTGCCTAGGTGGAGTGCAGTGGCACAAACACTGCTCACTGCAG
CCTCGACCTCGCAGGCTTGAGGGATCCTCCCACCTCAGCCTCCCAAGTAGCTGGAATCAC
AGGCAGGCACCACCACGCCCAGCTAATTTTCTATTTTTTGTAGAGGCAGGGTCTCACTAT
GTTGCCCAGGCTGGTCTTGAACTCCTGGGCTCAAGTGATCCTCCCACCTAAGCTTCCCAA
AGTGCTGGGATTACAGGTGTGAGCCACCATGCCTGGCTGGCTTAGCTTTTAGAAGGAGTC
CCTCATCCGGGCATGGTGGCTCATGCCTGTAATCCCAGCACTTTGGGAGGCCGAGGCAGG
CGGATCATGAGGTCAGGAGTTCAAGACCTGCCTGACCAACATGGTGAAACCCCATCTCTA
CTAAAAATACAAAAAATTAGCTGGGCGTGATGGCACACACCTATAATCCCAGCTACTCAG
GAAGCTGAGGCAGAAGAATTGCTTGAACCTAGGAGGCGGAGGTTACAGTGAGCCAAGATG
GCGCCACTGCTCTCCAGCCTGAGCGACAGAGCGAGACTCTGTCTCAAAAAAGAAAAAAAT
CAAAAATAAAAATAAAAATAAAAATTAACTGGGCATGGTGGCACAAGCCTGTAATCCCAG
CTACTCGGGAGGCTGAGGCAGGAGAATTGCTGGAACCAGGGAGGCAGACATTGCAGTGAG
CCGAGATTGCACCACTGCACTCCAGCCTGGGTGACAGAGCGAGACTCCGTCTCCAAAAAA
AAAAGTTAAAAAGATAGGCAATACATGGACATGTTACAAAGGCAAAAAAAGCAATCGTTC
AAAAGAGCAGAGTGAAAAGCCTTCCACCCCTGGCAGTCCCTATCAAGTTCCTCTCCCTAA
CGGTACCATCTCCTCAGACATCCATCAGGGCATCCTGTGCTTATTTGAGCATATGTGTGT
ATATTAATACCCCTTTTTAAAACACAAATAGCCTACGTGCTGCTGGGCACCTTGCTTTTT
TGGTATGCGTATATTTAAGATCCGCTGGGTTTCAGTATCCCATTTCATGGCTGTGCTATA
ATTAACCAGTTCCCTACATCAGCAGGACAAGGGGTTTGTTGTACAATGTCTCCACCTATC
TTACGCTCCTGAGCTCCCACCCTACCTTGTAGGATACCTGTAGGGAAAATTCCTAGTAGT
GAAATAGCTGCATCAAAGGAAAAGTAGTGCTTTTAATAGTCCCACATTAGAAACACCCTA
AATAGTCAATGGTAAGGAAGTAGATAAATAAAACTTGAAGATATAAAGGCATATCCATAG
GATAAAATACTGCACGTTTATTAAAATTCATGTTGCAGAACATGTAGTAACACGGACAGA
CTTCTACAACTGGTGAAAAAAGTGTACAGTAAGAATCTAACCACGTAAAAATATATCAGT
GCATATGCACCAAATGCACATTACGGAGTAGAAAGAACTCGTCTGGGGAGGGATCAAGGA
GATACGTATTTTGTTGTAATTTCTGTACTTTCCCATTTTTCTACAGTATGAATTACTTTT
GTGGTAAGAGGAAAAAAGGGAGAAAGCCCTCGGCTGTCCAGGAGCAGAGCTGGGCTGGGA
GGTGGGGAGGGCCCGCGGACCCGTTCTCCCTGAAAGCCCCTGTCACAGTGGGACTCTGAA
GGGCTCACCCACACGGGACCCTGCGCTCGGTCCTCACCACCAACGCCCGCACACTAGGCA
GTGACCGGAGAGAGCTGGGGGACATGGCCTGCGCGCACCCCTCGCACGGCTAGGCCCGGC
GGTGGGAGTTAAAGGGAGGCCGGTTCCAACTCGGCTGAAGGCAGGCCATTCTGACGGCTG
CCCCCAGGAGGGCGGCTGCGAGGGCAGCGGTGCGCTCCCGGCACGGGGGTGCTCGAGCAC
TGAGTCCGGGCATGGAGCAGCGAAGGCGCCGCCTGCAGTGCCCACGGACCAAACGGGGGT
GACCTCTGAGGCCGCCGGCAGCTCCGAGGTCGCGTGGGATCCGGGCTCCAGGCGCCTCCG
CTCTGCCGCCCACCCCATCCCTCTGGCTCCGGGCCTCCGCGTCCTCCCACCACAGGGTGG
GGACTCGTTGCGGTCCCTACCCAGCCCATACCTGTACGACGTGGTCACTGCTGCAGCCGC
GTCCGCGTCGCCGATGGGCAGCACGTAGACCCCGCGGGCGCCGGGCGCAGGTGGCGCGGA
GGACTGCGCGGAGGATTTGCCCCTGCGGCCGCCCGCCCCCGGTCCGCGCCCCGGCGGCGG
ATCCTTGGGCCCGGCGGGCGTGGTCCACAAGCCGAAGTCCCGCTGGTACTGAGTGAGCGG
CACGTCCCGGCCGGAATCCCGGGCGCCCGCGGGAGGCTGGCCCCTGCGCGAGGCGGCGCC
GCCCGTGCCCGGCTCCTCGCTGTCGAGGTCCGAGTAGCCGTGCAGAGTGAGCGGCACCGC
CACGTCGGAGCGGTCCAGCTGGTTCCAGCGCCGCGCCAGGCAGCACAGGCGGCTGATACA
GGGCCACGCCATGCCAGCCCCGGCGCCCGCCGCCCCGCTCCCGGCGCGCGGCGCTCCCG
